▓▓▓▓▓▓▓▓▓▓F▓▓▓▓▓▓▓▓▓▓
▓▓▓▓▓▓▓▓▓▓ ▓▓▓▓▓▓▓▓▓▓
▓▓▓▓▓▓▓▓▓  ▓▓▓▓▓▓▓▓▓▓
▓▓▓▓▓▓▓▓▓ ▓▓▓▓▓▓▓▓▓▓▓
▓▓▓▓▓▓▓▓▓  ▓▓▓▓▓▓▓▓▓▓
▓▓▓▓▓▓▓▓▓▓ ▓▓▓▓▓▓▓▓▓▓
▓▓▓▓▓▓▓▓▓▓S▓▓▓▓▓▓▓▓▓▓
