▓▓▓×▓▓▓▓▓▓▓▓▓▓▓▓▓▓▓▓▓
▓   ▓▓▓▓ ▓▓▓▓▓▓▓▓▓▓▓▓
▓▓▓ ▓▓▓▓ ▓▓▓   ▓▓▓▓▓▓
▓▓▓   ▓▓   ▓▓▓ ▓▓▓▓▓▓
▓▓▓ ▓▓▓▓ ▓▓▓▓▓ ▓▓▓▓▓▓
▓▓▓ ▓             ▓▓▓
▓▓▓ ▓▓▓ ▓▓ ▓▓▓ ▓▓ ▓▓▓
▓▓▓     ▓▓ ▓▓▓ ▓▓▓▓▓▓
▓▓▓▓▓▓▓▓▓▓$▓▓▓▓▓▓▓▓▓▓
