▓▓▓F▓▓▓▓▓▓▓▓▓▓▓▓▓▓▓▓▓
▓   ▓▓▓▓ ▓▓▓▓▓▓▓▓▓▓▓▓
▓▓▓ ▓▓▓▓ ▓▓▓   ▓▓▓▓▓▓
▓▓▓   ▓▓   ▓▓▓ ▓▓▓▓▓▓
▓▓▓ ▓▓▓▓ ▓▓▓▓▓ ▓▓▓▓▓▓
▓▓▓ ▓             ▓▓▓
▓▓▓ ▓▓▓ ▓▓ ▓▓▓ ▓▓ ▓▓▓
▓▓▓     ▓▓ ▓▓▓ ▓▓▓▓▓▓
▓▓▓▓▓▓▓▓▓▓S▓▓▓▓▓▓▓▓▓▓
